You and your wife Saffi head to the Hogtooth Tavern for your usual date night. With the meal complete and cleared from your table, conversation drifts to the mundane as you finish your ale.
(Please save a transcript! Type TRANSCRIPT to start, save to a .txt file, and see "Contact the author" in the HELP menu for how to send it to me. This helps a lot in debugging and developing the game.)

Hogtooth Tavern
An unfinished proof of concept for 8 Bits to Infinity Text Only Jam by Joshua McLean
Release 0 / Serial number 191220 / Inform 7 build 6M62 (I6/v6.33 lib 6/12N) SD

Main Hall (on your chair)
This hall lit dimly by rows after row of candles along the walls features a large benched table to the south and several round tables with chairs in the center. Along the north wall runs a bar, and a passage west leads to the cloakroom and the tavern's exit.

A stout, round man with curly black hair peeking over the top of his shirt. He's wiping down the bar with a rag.

A man with shoulder-cropped blond hair strums on a lute and sings a wordless tune, filling the empty tavern air above the many conversations with beautiful music.

You can also see Saffi's chair (on which is Saffi) here.

>wait
Time passes.

* * *

>n
(first getting off your chair)
(first opening the kitchen door)
You go around the bar into the kitchen.

Saffi arrives from the south.

Kitchen
An ordinary, nondescript tavern kitchen. A door in the south wall leads back to the main hall. There's also a trap door set in the floor.

Your wife, Saffi, is here.

>d
(first opening the trapdoor)
Saffi arrives from above.

Cellar
A wine cellar. There's a passage heading south for some reason.

Your wife, Saffi, is here.

The barkeep is huddled in the corner here, his hands over his head.

>s
Saffi arrives from the north.

Portal Room
Your wife, Saffi, is here.

A glowing portal beckons you to enter.

>enter portal
It's quite possible this portal goes one way. Best be sure you have everything you need, then try again.

>enter portal
You step through the portal, blinded by its brightness before all fades to black. When your vision returns, you find yourself in...

Ruined Courtyard
The shattered stone towers and cracked ground make it difficult to recognize this place, but there is a certain energy that makes you feel at home. The eerie, dark purple tint of the sky forces you to shiver. This place was once a world of life and safety, but is now the domain of Bardolf Malgerius.

Dwarfing the remains of fallen castle structures to the north, a massive chapel stands on the site of Bardolf's former dark magic. This was meant to contain the evil energy that permeates this place. It has clearly failed.

The minstrel is here, looking confused - and somewhat odd without an instrument.

>n
You'll have to say which compass direction to go in.
I didn't understand that instruction.

Chapel
(This is where the final conflict was meant to take place. But you've reached the end of available content. Congratulations...? And thanks for playing! - Joshua McLean)

>restart
Are you sure you want to restart?

>y
Hogtooth Tavern
An unfinished proof of concept for 8 Bits to Infinity Text Only Jam by Joshua McLean
Release 0 / Serial number 191220 / Inform 7 build 6M62 (I6/v6.33 lib 6/12N) SD

Main Hall (on your chair)
This hall lit dimly by rows after row of candles along the walls features a large benched table to the south and several round tables with chairs in the center. Along the north wall runs a bar, and a passage west leads to the cloakroom and the tavern's exit.

A stout, round man with curly black hair peeking over the top of his doublet wipes down the bar with a rag.

A man with shoulder-cropped blond hair strums on a lute and sings a wordless tune, filling the empty tavern air above the many conversations with beautiful music.

You can also see Saffi's chair (on which is Saffi) here.

>x saffi
Your wife - a woman with long, flowing light purple hair and a quirky smile which brightens the worst of days.

>ask saffi about tavern
She looks at you. "I like this place. It's warm and cozy, but not too cramped." She's lucky she doesn't have to deal with the keeper.

>think about tavern
Hogtooth has been your go-to tavern for decades. You appreciate the somewhat quieter clientele and the rotation of minstrels providing a variety of musical talent. The ale's not bad, either. And all of that makes up for the grumpy barkeep.

>think about saffi
You married Saffi six years ago, right before opening up your own shop. She's been your constant companion ever since. The two of you have been waiting for the shop to stabilize before starting a family, and you're right on the cusp of it. Maybe next year.

>think about marriage
You can't see any such thing.

>think about minstrels
You can't see any such thing.

>think about minstrel
He appears to be enjoying himself immensely. You wonder whether he truly is, as most of the patrons ignore his hardworked talent in favor of their companions and ale.

>help
> Introduction to Hogtooth Tavern
   Instructions for Play
   Additional commands
   Contact the author
   Additional credits

>[down]
Introduction to Hogtooth Tavern
 > Instructions for Play
   Additional commands
   Contact the author
   Additional credits

   Introduction to Hogtooth Tavern
 > Instructions for Play
   Additional commands
   Contact the author
   Additional credits

>[down]
Introduction to Hogtooth Tavern
   Instructions for Play
 > Additional commands
   Contact the author
   Additional credits

   Introduction to Hogtooth Tavern
   Instructions for Play
 > Additional commands
   Contact the author
   Additional credits

>[down]
Introduction to Hogtooth Tavern
   Instructions for Play
   Additional commands
 > Contact the author
   Additional credits

   Introduction to Hogtooth Tavern
   Instructions for Play
   Additional commands
 > Contact the author
   Additional credits

>[down]
Introduction to Hogtooth Tavern
   Instructions for Play
   Additional commands
   Contact the author
 > Additional credits

   Introduction to Hogtooth Tavern
   Instructions for Play
   Additional commands
   Contact the author
 > Additional credits

>[up]
Introduction to Hogtooth Tavern
   Instructions for Play
   Additional commands
 > Contact the author
   Additional credits

   Introduction to Hogtooth Tavern
   Instructions for Play
   Additional commands
 > Contact the author
   Additional credits

>[up]
Introduction to Hogtooth Tavern
   Instructions for Play
 > Additional commands
   Contact the author
   Additional credits

   Introduction to Hogtooth Tavern
   Instructions for Play
 > Additional commands
   Contact the author
   Additional credits

>[enter]
Conversation and remembrance are two key parts of this adventure.

You can TALK TO (person) to initiate conversation, then ASK ABOUT (something). A shortcut is to ASK (person) ABOUT (something) which will initiate conversation and ask about the topic.

You can also TELL (something) or shorthand TELL (person) ABOUT (something) to inform other characters about people, places, or things.

Stuck? Try a plain THINK or PONDER for a general review what you've learned so far. Also, HINT will give you a menu of hints.

UNDO is enabled in this game because I'm a nice person. But be careful about overusing it. That's a good way to break the game. :(

If you have parchment and a pen, you can WRITE (message) ON PARCHMENT. Whenever you write a message, it overwrites the previous message. You can READ PARCHMENT to see the text and ERASE PARCHMENT to clear all text in it. If you're worried about overwriting the information in the notebook, use PROTECT PARCHMENT and the game will stop you from changing the text. Use UNPROTECT PARCHMENT if you want to edit it again.

You can EMPTY a container which drops everything in it onto the floor--including things you can't normally remove like liquids.

Check your SCORE to see how many points you've found. Some of these are secrets!

Please press SPACE to continue.

Introduction to Hogtooth Tavern
   Instructions for Play
 > Additional commands
   Contact the author
   Additional credits

   Introduction to Hogtooth Tavern
   Instructions for Play
 > Additional commands
   Contact the author
   Additional credits

>[down]
Introduction to Hogtooth Tavern
   Instructions for Play
   Additional commands
 > Contact the author
   Additional credits

   Introduction to Hogtooth Tavern
   Instructions for Play
   Additional commands
 > Contact the author
   Additional credits

>[enter]
If you find any bugs, typos, weird responess, or simply want to comment on the game, please contact me. Please include a transcript with your email if you have one. I appreciate your help!

E-mail:  joshua.mclean@8bitstoinfinity.com Twitter: @MrJoshuaMcLean Website: https://joshua-mclean.itch.io/

Please press SPACE to continue.

Introduction to Hogtooth Tavern
   Instructions for Play
   Additional commands
 > Contact the author
   Additional credits

   Introduction to Hogtooth Tavern
   Instructions for Play
   Additional commands
 > Contact the author
   Additional credits

>q
Main Hall (on your chair)
This hall lit dimly by rows after row of candles along the walls features a large benched table to the south and several round tables with chairs in the center. Along the north wall runs a bar, and a passage west leads to the cloakroom and the tavern's exit.

A stout, round man with curly black hair peeking over the top of his doublet wipes down the bar with a rag.

A man with shoulder-cropped blond hair strums on a lute and sings a wordless tune, filling the empty tavern air above the many conversations with beautiful music.

You can also see Saffi's chair (on which is Saffi) here.

>transcript
Attempt to begin transcript failed.

Thank you for enabling the transcript! This seven-day prototype is likely riddled with bugs and strange responses, and the hints may be a bit lacking.

Please put an asterisk * before commands which you mean to be notes. For example, you might type:

> * I don't think this is the correct room description.

Please mail the transcript file to joshua.mclean@8bitstoinfinity.com. I really appreciate the help. Every transcript will help make the game better!

* * *

>l
Main Hall (on your chair)
This hall lit dimly by rows after row of candles along the walls features a large benched table to the south and several round tables with chairs in the center. Along the north wall runs a bar. The place is eerily silent following the dragon attack, the only sound a crinkle of embers from the hole where the cloakroom once was.

You can see the lute and Saffi's chair (on which is Saffi) here.

>w
Chasing after the dragon doesn't sound like a fun night to you. There must be a safer place to escape... or hide.

>w
Chasing after the dragon doesn't sound like a fun night to you. There must be a safer place to escape... or hide.

* * *

>restart
Are you sure you want to restart?

>y
You and your wife Saffi head to the Hogtooth Tavern for your usual date night. With the meal complete and cleared from your table, conversation drifts to the mundane as you finish your ale.
(Please save a transcript! Type TRANSCRIPT to start, save to a .txt file, and see "Contact the author" in the HELP menu for how to send it to me. This helps a lot in debugging and developing the game.)

Hogtooth Tavern
An unfinished proof of concept for 8 Bits to Infinity Text Only Jam by Joshua McLean
Release 0 / Serial number 191220 / Inform 7 build 6M62 (I6/v6.33 lib 6/12N) SD

Main Hall (on your chair)
This hall lit dimly by rows after row of candles along the walls features a large benched table to the south and several round tables with chairs in the center. Along the north wall runs a bar, and a passage west leads to the cloakroom and the tavern's exit.

A stout, round man with curly black hair peeking over the top of his shirt. He's wiping down the bar with a rag.

A man with shoulder-cropped blond hair strums on a lute and sings a wordless tune, filling the empty tavern air above the many conversations with beautiful music.

You can also see Saffi's chair (on which is Saffi) here.

* * *

>x candles
Dozens if not hundreds of candles in broken or misshapen mugs fight back the darkness with their flickering light.

>think about candles
The reuse of mugs for the candles is a clever trick, adding a unique decoration to the place. Probably saves on candle jars, too.

>ask saffi about candles
She looks at you. "I don't know about them. The candlelight is nice, but those steel mugs just aren't aesthetic at all.

>l
Main Hall (on your chair)
This hall lit dimly by rows after row of candles along the walls features a large benched table to the south and several round tables with chairs in the center. Along the north wall runs a bar, and a passage west leads to the cloakroom and the tavern's exit.

A stout, round man with curly black hair peeking over the top of his shirt. He's wiping down the bar with a rag.

A man with shoulder-cropped blond hair strums on a lute and sings a wordless tune, filling the empty tavern air above the many conversations with beautiful music.

You can also see Saffi's chair (on which is Saffi) here.

>think about chairs
You can't use multiple objects with that verb.

>think about chair
Which do you mean, the bench, Saffi's chair, or your chair?

>mine
It's a chair. Were you expecting some deep thoughts?

>think about my chair
It's a chair. Were you expecting some deep thoughts?

>x my chair
It's an ordinary wooden chair. Not cozy, but with a few mugs of ale down, it's less of an issue.

>ask saffi about chair
Which do you mean, the bench, Saffi's chair, or your chair?

>bench
Her left eyebrow rises, ever so slightly.

>l
Main Hall (on your chair)
This hall lit dimly by rows after row of candles along the walls features a large benched table to the south and several round tables with chairs in the center. Along the north wall runs a bar, and a passage west leads to the cloakroom and the tavern's exit.

A stout, round man with curly black hair peeking over the top of his shirt. He's wiping down the bar with a rag.

A man with shoulder-cropped blond hair strums on a lute and sings a wordless tune, filling the empty tavern air above the many conversations with beautiful music.

You can also see Saffi's chair (on which is Saffi) here.

>x chair
Which do you mean, the bench, Saffi's chair, or your chair?

>mine
It's an ordinary wooden chair. Not cozy, but with a few mugs of ale down, it's less of an issue.