Text Only Jam
TODO Headline by Joshua McLean
Release 3 / Serial number 191219 / Inform 7 build 6M62 (I6/v6.33 lib 6/12N) SD

Main Hall (on your chair)
This hall lit dimly by rows after row of candles along the walls features a large benched table to the south and several round tables with chairs in the center. Along the north wall runs a bar, and a passage west leads to the cloakroom and the tavern's exit.

A stout, round man with curly black hair peeking over the top of his doublet wipes down the bar with a rag.

A man with shoulder-cropped blond hair strums on a lute and sings a wordless tune, filling the empty tavern air above the many conversations with beautiful music.

You can also see Saffi's chair (on which is Saffi) here.

>stand
You get off your chair.

Main Hall
This hall lit dimly by rows after row of candles along the walls features a large benched table to the south and several round tables with chairs in the center. Along the north wall runs a bar, and a passage west leads to the cloakroom and the tavern's exit.

A stout, round man with curly black hair peeking over the top of his doublet wipes down the bar with a rag.

A man with shoulder-cropped blond hair strums on a lute and sings a wordless tune, filling the empty tavern air above the many conversations with beautiful music.

You can also see Saffi's chair (on which is Saffi) and your chair here.

>ask keeper about ale
The barkeep looks at you expectantly.

The barkeep pulls a mug of ale and pounds it on the counter. "Two copper," he says.

>pay for ale
You give 2 coins to barkeep to pay for the mug.

>get mug
Taken.

>ask keeper about ale
"How about ye finish that one first, lad?" He points at the full mug in your hand.

>buy ale
Try asking about the mug instead.

>ask keeper about mug
"How about ye finish that one first, lad?" He points at the full mug in your hand.

>drink mug
You drink ale from the mug. Tasty!

* * *

>think about dragons
You can't see any such thing.

>wait
Time passes.

>wait
Time passes.

>wait
Time passes.

A deafening roar blasts through the cacaphony of voices and the minstrel's music, causing all to stop and fall silent. Seconds pass with patrons exchanging looks of fear and confusion.

A column of fire blasts through the cloakroom and it's gone in an instant, now a pile of smoldering ash and sparks. The silence gives way to screams and panic as each person jumps from their seat.

Something massive and scaled zooms by the gaping hole into the streets where the cloakroom once was. A dragon? No, impossible.

Everyone takes their chance to flee through the enlarged exit, and soon the room is silent again. Only you, Saffi, and the minstrel's lute remain. She looks at you as if asking what to do next.

>think about dragon
That isn't available.

* * *

>think about dragons
You can't see any such thing.

>showme dragons
dragon - subject
location: out of play
singular-named, improper-named; unlit, inedible, portable, unseen, familiar, paid
list grouping key: none
printed name: "dragon"
printed plural name: "subjects"
indefinite article: none
description: none
initial appearance: none
bulk: 5
thought: "Probably some wizard's trick. Dragons are nothing more than legend."
coin value: 1
shop owner: a person
Saffi-thought: "She laughs nervously. "Nah, that wasn't a dragon. It was... something else. Dragons aren't real.""

>purloin dragons
[Purloined.]

>think about dragons
Probably some wizard's trick. Dragons are nothing more than legend.

>showme dragons
dragon - subject
location: carried by yourself on your chair in the Main Hall
singular-named, improper-named; unlit, inedible, portable, handled, unseen, familiar, paid
list grouping key: none
printed name: "dragon"
printed plural name: "subjects"
indefinite article: none
description: none
initial appearance: none
bulk: 5
thought: "Probably some wizard's trick. Dragons are nothing more than legend."
coin value: 1
shop owner: a person
Saffi-thought: "She laughs nervously. "Nah, that wasn't a dragon. It was... something else. Dragons aren't real.""

>i
You are carrying:
  a dragon
  the coin purse

>showme xyzzy
Xyzzy - subject
location: out of play
singular-named, proper-named; unlit, inedible, portable, unseen, familiar, paid
list grouping key: none
printed name: "Xyzzy"
printed plural name: "subjects"
indefinite article: none
description: none
initial appearance: none
bulk: 5
thought: "A magic word, but what could it mean?"
coin value: 1
shop owner: a person
Saffi-thought: none

>ponder xyzzy
That isn't available.

* * *

>showme dragons
dragon - subject
location: out of play
singular-named, improper-named; unlit, inedible, portable, unseen, familiar, paid
list grouping key: none
printed name: "dragon"
printed plural name: "subjects"
indefinite article: none
description: none
initial appearance: none
bulk: 5
thought: "Probably some wizard's trick. Dragons are nothing more than legend."
coin value: 1
shop owner: a person
Saffi-thought: "She laughs nervously. "Nah, that wasn't a dragon. It was... something else. Dragons aren't real.""

>rules all
Rules tracing now switched to "all". Type "rules off" to switch it off again.

>think about dragons
[Rule "declare everything initially unmentioned rule" applies.]
[Rule "announce items from multiple object lists rule" applies.]
[Rule "set pronouns from items from multiple object lists rule" applies.]
[Rule "before stage rule" applies.]
[Rule "giving orders needs an interlocutor rule" does not apply (wrong action).]
[Rule "can't converse with absent interlocutor rule" does not apply (wrong action).]
[Rule "greet a new interlocutor rule" does not apply (wrong action).]
[Rule "implicit-conversing needs current interlocutor rule" does not apply (wrong action).]
That isn't available.

[Rule "A first turn sequence rule" applies.]
[Rule "every turn stage rule" applies.]
[Rule "reset protocol rule" applies.]
[Rule "Every turn" applies.]
[Rule "variable advance time rule" applies.]
[Rule "A last turn sequence rule" applies.]
[Rule "notify score changes rule" applies.]

>a dragons
[Rule "declare everything initially unmentioned rule" applies.]
[Rule "announce items from multiple object lists rule" applies.]
[Rule "set pronouns from items from multiple object lists rule" applies.]
[Rule "before stage rule" applies.]
[Rule "giving orders needs an interlocutor rule" does not apply (wrong action).]
[Rule "can't converse with absent interlocutor rule" does not apply (wrong action).]
[Rule "greet a new interlocutor rule" does not apply (wrong action).]
[Rule "implicit-conversing needs current interlocutor rule" applies.]
You need to specify who you want to speak to.

[Rule "A first turn sequence rule" applies.]
[Rule "every turn stage rule" applies.]
[Rule "reset protocol rule" applies.]
[Rule "Every turn" applies.]
[Rule "variable advance time rule" applies.]
[Rule "A last turn sequence rule" applies.]
[Rule "notify score changes rule" applies.]

>talk to wife
[Rule "declare everything initially unmentioned rule" applies.]
[Rule "announce items from multiple object lists rule" applies.]
[Rule "set pronouns from items from multiple object lists rule" applies.]
[Rule "before stage rule" applies.]
[Rule "giving orders needs an interlocutor rule" does not apply (wrong action).]
[Rule "can't converse with absent interlocutor rule" does not apply (wrong action).]
[Rule "greet a new interlocutor rule" does not apply (wrong action).]
[Rule "implicit-conversing needs current interlocutor rule" does not apply (wrong action).]
[Rule "instead stage rule" applies.]
[Rule "Instead of saying hello to the barkeep when the player is seated" does not apply (wrong action).]
[Rule "Instead of saying hello to the barkeep" does not apply (wrong action).]
[Rule "Instead of saying hello to the minstrel" does not apply (wrong action).]
[Rule "investigate player's awareness before action rule" applies.]
[Rule "player aware of his own actions rule" applies.]
[Rule "check stage rule" applies.]
[Rule "can't greet current interlocutor rule" does not apply (wrong action).]
[Rule "can't greet yourself rule" does not apply (wrong action).]
[Rule "carry out stage rule" applies.]
[Rule "note current interlocutor when greeted rule" applies.]
[Rule "after stage rule" applies.]
[Rule "After saying hello to Saffi when the greeting type is explicit" applies.]
She looks at you.

[Rule "A first turn sequence rule" applies.]
[Rule "every turn stage rule" applies.]
[Rule "reset protocol rule" applies.]
[Rule "Every turn" applies.]
[Rule "variable advance time rule" applies.]
[Rule "A last turn sequence rule" applies.]
[Rule "notify score changes rule" applies.]

>dragon
I didn't understand that sentence.

>a dragon
[Rule "declare everything initially unmentioned rule" applies.]
[Rule "announce items from multiple object lists rule" applies.]
[Rule "set pronouns from items from multiple object lists rule" applies.]
[Rule "before stage rule" applies.]
[Rule "giving orders needs an interlocutor rule" does not apply (wrong action).]
[Rule "can't converse with absent interlocutor rule" does not apply (wrong action).]
[Rule "greet a new interlocutor rule" does not apply (wrong action).]
[Rule "implicit-conversing needs current interlocutor rule" does not apply (wrong action).]
[Rule "instead stage rule" applies.]
[Rule "Instead of implicit-quizzing" applies.]
[Rule "announce items from multiple object lists rule" applies.]
[Rule "set pronouns from items from multiple object lists rule" applies.]
[Rule "before stage rule" applies.]
[Rule "giving orders needs an interlocutor rule" does not apply (wrong action).]
[Rule "can't converse with absent interlocutor rule" does not apply (wrong action).]
[Rule "greet a new interlocutor rule" does not apply (wrong action).]
[Rule "implicit-conversing needs current interlocutor rule" does not apply (wrong action).]
[Rule "instead stage rule" applies.]
[Rule "Instead of quizzing the barkeep about something when the player is seated" does not apply (wrong action).]
[Rule "Instead of quizzing the barkeep about a beverage" does not apply (wrong action).]
[Rule "Instead of quizzing Saffi about a thing ( called the target )" applies.]
She laughs nervously. "Nah, that wasn't a dragon. It was... something else. Dragons aren't real."

[Rule "A first turn sequence rule" applies.]
[Rule "every turn stage rule" applies.]
[Rule "reset protocol rule" applies.]
[Rule "Every turn" applies.]
[Rule "variable advance time rule" applies.]
[Rule "A last turn sequence rule" applies.]
[Rule "notify score changes rule" applies.]

* * *

>think about dragons
You can't see any such thing.

>ponder dragons
You can't see any such thing.

>rules all
Rules tracing now switched to "all". Type "rules off" to switch it off again.

>ponder dragons
You can't see any such thing.

>ponder dragons
You can't see any such thing.

* * *

>ponder dragons
You can't see any such thing.

* * *

>ponder dragons
You can't see any such thing.

>purloin dragons
[Rule "declare everything initially unmentioned rule" applies.]
[Purloined.]

>ponder dragons
[Rule "declare everything initially unmentioned rule" applies.]
[Rule "announce items from multiple object lists rule" applies.]
[Rule "set pronouns from items from multiple object lists rule" applies.]
[Rule "before stage rule" applies.]
[Rule "giving orders needs an interlocutor rule" does not apply (wrong action).]
[Rule "can't converse with absent interlocutor rule" does not apply (wrong action).]
[Rule "greet a new interlocutor rule" does not apply (wrong action).]
[Rule "implicit-conversing needs current interlocutor rule" does not apply (wrong action).]
[Rule "instead stage rule" applies.]
[Rule "investigate player's awareness before action rule" applies.]
[Rule "player aware of his own actions rule" applies.]
[Rule "check stage rule" applies.]
[Rule "Check thinking about something" applies.]
[Rule "carry out stage rule" applies.]
[Rule "after stage rule" applies.]
[Rule "investigate player's awareness after action rule" applies.]
[Rule "report stage rule" applies.]
[Rule "Report thinking about something" applies.]
Probably some wizard's trick. Dragons are nothing more than legend.

[Rule "last specific action-processing rule" applies.]
[Rule "A first turn sequence rule" applies.]
[Rule "every turn stage rule" applies.]
[Rule "reset protocol rule" applies.]
[Rule "Every turn" applies.]
[Rule "variable advance time rule" applies.]
[Rule "A last turn sequence rule" applies.]
[Rule "notify score changes rule" applies.]

* * *

>think about me
Fourteen years ago, you were squire to the knight Sir Galien, who came up against the dark mage Bardolf Malgerius and failed. You were wrongfully accused for Sir Galien's murder but managed to escape and save King Nichol from the same fate at Bardolf's hands.

The king offered you a position on his Kingsguard, but you refused. That adventure was enough for your lifetime. So instead, you settled in as apprentice to a shopkeeper, starting your life anew.

Nine years later, you now run your own shop with a number of regular patrons and hardworking employees. It's much cozier than getting yourself killed like Galien did - and you don't miss the adventure. Not one bit.

>think about saffi
You married Saffi six years ago, right before opening up your own shop. She's been your constant companion ever since. The two of you have been waiting for the shop to stabilize before starting a family, and you're right on the cusp of it. Maybe next year.

>think about tavern
You can't see any such thing.

>think about dragons
You can't see any such thing.

>showme tavern
hogtooth tavern - region
singular-named, improper-named, Saffi-familiar
list grouping key: none
printed name: "hogtooth tavern"
printed plural name: "regions"
indefinite article: none
thought: "Hogtooth has been your go-to tavern for decades. You appreciate the somewhat quieter clientele and the rotation of minstrels providing a variety of musical talent. The ale's not bad, either. And all of that makes up for the grumpy barkeep."
Saffi-thought: ""I like this place. It's warm and cozy, but not too cramped." She's lucky she doesn't have to deal with the keeper."