Text Only Jam
TODO Headline by Joshua McLean
Release 3 / Serial number 191216 / Inform 7 build 6M62 (I6/v6.33 lib 6/12N) SD

Start

>x me
As good-looking as ever.

>help
> Introduction to Text Only Jam
   Instructions for Play
   Additional commands
   Contact the author
   Additional credits

>[esc]
Start

* * *

Text Only Jam
TODO Headline by Joshua McLean
Release 3 / Serial number 191216 / Inform 7 build 6M62 (I6/v6.33 lib 6/12N) SD

Start

>godamn
I didn't understand that sentence.

>goddamn
I didn't understand that sentence.

>damn
We'll have none of that!

>well damn
We'll have none of that!

>motherfucker
I didn't understand that sentence.

* * *

Text Only Jam
TODO Headline by Joshua McLean
Release 3 / Serial number 191216 / Inform 7 build 6M62 (I6/v6.33 lib 6/12N) SD

Start

>motherfuck
We'll have none of that!

>hint
Some players may find the temptation to rely on hints overwhelming, and you may prefer to remove temptation by disabling hints for the rest of this game. If you do so, however, you will not be able to access the hints unless you restart. Do you wish to disable hints? >

>n
Okay - but if you change your mind later you can use the HINTS OFF command to disable hints.

Sorry, no hints are available at this time.

>fuck
We'll have none of that!

* * *

Text Only Jam
TODO Headline by Joshua McLean
Release 3 / Serial number 191216 / Inform 7 build 6M62 (I6/v6.33 lib 6/12N) SD

Start

>think about me
You're pretty cool.

>think
I stop and think for a moment. Maybe I need a HINT.

>ponder
I stop and think for a moment. Maybe I need a HINT.

* * *

>think about me
You're pretty cool.

>think about start
You can't see any such thing.

>x me
As good-looking as ever.

* * *

>think about me
You're pretty cool.

>l
Start

>x me
As good-looking as ever.

* * *

Text Only Jam
TODO Headline by Joshua McLean
Release 3 / Serial number 191216 / Inform 7 build 6M62 (I6/v6.33 lib 6/12N) SD

Start

>think about xyzzy
It's a magic word that does magical things.

>actions
Actions listing on.

>think about xyzzy
You can't see any such thing.

>rules
Rules tracing now switched on. Type "rules off" to switch it off again, or "rules all" to include even rules which do not apply.

>think about xyzzy
You can't see any such thing.

>rules all
[Rule "declare everything initially unmentioned rule" applies.]
Rules tracing now switched to "all". Type "rules off" to switch it off again.

>think about xyzzy
You can't see any such thing.

>x me
[Rule "declare everything initially unmentioned rule" applies.]
[examining yourself]
[Rule "announce items from multiple object lists rule" applies.]
[Rule "set pronouns from items from multiple object lists rule" applies.]
[Rule "before stage rule" applies.]
[Rule "giving orders needs an interlocutor rule" does not apply (wrong action).]
[Rule "Before doing something to a secret door which is unrevealed" does not apply (wrong action).]
[Rule "Before doing something to a secret switch which is unrevealed" does not apply (wrong action).]
[Rule "can't converse with absent interlocutor rule" does not apply (wrong action).]
[Rule "greet a new interlocutor rule" does not apply (wrong action).]
[Rule "implicit-conversing needs current interlocutor rule" does not apply (wrong action).]
[Rule "Before doing something when a secret door is the second noun and the second noun is unrevealed" does not apply (wrong action).]
[Rule "Before doing something when a secret switch is the second noun and the second noun is unrevealed" does not apply (wrong action).]
[Rule "can't act in the dark rule" applies.]
[Rule "keychain-aware carrying requirements rule" applies.]
[Rule "instead stage rule" applies.]
[Rule "investigate player's awareness before action rule" applies.]
[Rule "player aware of his own actions rule" applies.]
[Rule "check stage rule" applies.]
[Rule "carry out stage rule" applies.]
[Rule "mark items as seen on examining rule" applies.]
[Rule "standard examining rule" applies.]
As good-looking as ever.

[Rule "examine directions rule" applies.]
[Rule "examine containers rule" applies.]
[Rule "examine supporters rule" applies.]
[Rule "examine devices rule" applies.]
[Rule "examine undescribed things rule" applies.]
[Rule "after stage rule" applies.]
[Rule "passkey description rule" does not apply (wrong action).]
[Rule "notepad output rule" does not apply (wrong action).]
[Rule "investigate player's awareness after action rule" applies.]
[Rule "report stage rule" applies.]
[Rule "describe drawered objects rule" does not apply (wrong action).]
[Rule "report other people examining rule" applies.]
[Rule "last specific action-processing rule" applies.]
[examining yourself - succeeded]

[Rule "A first turn sequence rule" applies.]
[Rule "every turn stage rule" applies.]
[Rule "Every turn" applies.]
[Rule "reset protocol rule" applies.]
[Rule "A last turn sequence rule" applies.]
[Rule "notify score changes rule" applies.]

>think about me
[Rule "declare everything initially unmentioned rule" applies.]
[pondering about yourself]
[Rule "announce items from multiple object lists rule" applies.]
[Rule "set pronouns from items from multiple object lists rule" applies.]
[Rule "before stage rule" applies.]
[Rule "giving orders needs an interlocutor rule" does not apply (wrong action).]
[Rule "Before doing something to a secret door which is unrevealed" does not apply (wrong action).]
[Rule "Before doing something to a secret switch which is unrevealed" does not apply (wrong action).]
[Rule "can't converse with absent interlocutor rule" does not apply (wrong action).]
[Rule "greet a new interlocutor rule" does not apply (wrong action).]
[Rule "implicit-conversing needs current interlocutor rule" does not apply (wrong action).]
[Rule "Before doing something when a secret door is the second noun and the second noun is unrevealed" does not apply (wrong action).]
[Rule "Before doing something when a secret switch is the second noun and the second noun is unrevealed" does not apply (wrong action).]
[Rule "keychain-aware carrying requirements rule" applies.]
[Rule "instead stage rule" applies.]
[Rule "investigate player's awareness before action rule" applies.]
[Rule "player aware of his own actions rule" applies.]
[Rule "check stage rule" applies.]
[Rule "carry out stage rule" applies.]
[Rule "after stage rule" applies.]
[Rule "investigate player's awareness after action rule" applies.]
[Rule "report stage rule" applies.]
[Rule "Report pondering about" applies.]
You're pretty cool.
[Rule "last specific action-processing rule" applies.]
[pondering about yourself - succeeded]

[Rule "A first turn sequence rule" applies.]
[Rule "every turn stage rule" applies.]
[Rule "Every turn" applies.]
[Rule "reset protocol rule" applies.]
[Rule "A last turn sequence rule" applies.]
[Rule "notify score changes rule" applies.]

>think about xyzzy
You can't see any such thing.

>think abou tit
I only understood you as far as wanting to think.

>think about it
I'm not sure what 'it' refers to.

>think about xyzzy
You can't see any such thing.

>think about m
You can't see any such thing.

>think about me
[Rule "declare everything initially unmentioned rule" applies.]
[pondering about yourself]
[Rule "announce items from multiple object lists rule" applies.]
[Rule "set pronouns from items from multiple object lists rule" applies.]
[Rule "before stage rule" applies.]
[Rule "giving orders needs an interlocutor rule" does not apply (wrong action).]
[Rule "Before doing something to a secret door which is unrevealed" does not apply (wrong action).]
[Rule "Before doing something to a secret switch which is unrevealed" does not apply (wrong action).]
[Rule "can't converse with absent interlocutor rule" does not apply (wrong action).]
[Rule "greet a new interlocutor rule" does not apply (wrong action).]
[Rule "implicit-conversing needs current interlocutor rule" does not apply (wrong action).]
[Rule "Before doing something when a secret door is the second noun and the second noun is unrevealed" does not apply (wrong action).]
[Rule "Before doing something when a secret switch is the second noun and the second noun is unrevealed" does not apply (wrong action).]
[Rule "keychain-aware carrying requirements rule" applies.]
[Rule "instead stage rule" applies.]
[Rule "investigate player's awareness before action rule" applies.]
[Rule "player aware of his own actions rule" applies.]
[Rule "check stage rule" applies.]
[Rule "carry out stage rule" applies.]
[Rule "after stage rule" applies.]
[Rule "investigate player's awareness after action rule" applies.]
[Rule "report stage rule" applies.]
[Rule "Report pondering about" applies.]
You're pretty cool.
[Rule "last specific action-processing rule" applies.]
[pondering about yourself - succeeded]

[Rule "A first turn sequence rule" applies.]
[Rule "every turn stage rule" applies.]
[Rule "Every turn" applies.]
[Rule "reset protocol rule" applies.]
[Rule "A last turn sequence rule" applies.]
[Rule "notify score changes rule" applies.]