Text Only Jam
TODO Headline by Joshua McLean
Release 3 / Serial number 191217 / Inform 7 build 6M62 (I6/v6.33 lib 6/12N) SD

Main Hall
On a chair is an armored woman with flowing purple hair.

>get woman
I don't suppose an armored woman with flowing purple hair would care for that.

* * *

Text Only Jam
TODO Headline by Joshua McLean
Release 3 / Serial number 191217 / Inform 7 build 6M62 (I6/v6.33 lib 6/12N) SD

Main Hall
On a chair is an armored woman with flowing purple hair.

>time
I didn't understand that sentence.

* * *

Text Only Jam
TODO Headline by Joshua McLean
Release 3 / Serial number 191217 / Inform 7 build 6M62 (I6/v6.33 lib 6/12N) SD

Main Hall
On a chair is an armored woman with flowing purple hair.

>xyzzy
You chant the magic word, "Xyzzy!"

An imp appears holding a metal circle with a pair of dials in the center. It reads 6:19 pm with a sun behind the dials.

In a flash, the imp disappears.

>l
Main Hall
On a chair is an armored woman with flowing purple hair.

>hi woman
"Hey," she says.

>what's up
I didn't understand that sentence.

>ask about tavern
There is no reply.

>ask about me
"You're okay. That's good."

>ask about her
"Oh, I'm Saffi. That's all I remember. And something about... a dragon?"

>xyzzy
You chant the magic word, "Xyzzy!"

An imp appears holding a metal circle with a pair of dials in the center. It reads: 6:25 pm

In a flash, the imp disappears.

* * *

>xyzzy
You chant the magic word, "Xyzzy!"

An imp appears holding a metal circle with a pair of dials in the center. It reads 6:19 pm with a sun behind the dials.

In a flash, the imp disappears.

>xyzzy
You chant the magic word, "Xyzzy!"

An imp appears holding a metal circle with a pair of dials in the center. It reads 6:19 pm with a sun behind the dials.

In a flash, the imp disappears.

I beg your pardon?

>n
You walk around the bar to get behind it.

Behind the Bar

>s
Main Hall
On a chair is an armored woman with flowing purple hair.

>n
You walk around the bar to get behind it.

Behind the Bar

* * *

>s
Main Hall
On a chair is an armored woman with flowing purple hair.

>time
I didn't understand that sentence.

>xyzzy
You chant the magic word, "Xyzzy!"

An imp appears holding a metal circle with a pair of dials in the center. It reads 6:22 pm with a sun behind the dials.

In a flash, the imp disappears.

>wait
Time passes.

>xyzzy
You chant the magic word, "Xyzzy!"

An imp appears holding a metal circle with a pair of dials in the center. It reads 6:24 pm with a sun behind the dials.

In a flash, the imp disappears.

>wait
Time passes.

>wait
Time passes.

The dragon attacks.

* * *

Text Only Jam
TODO Headline by Joshua McLean
Release 3 / Serial number 191217 / Inform 7 build 6M62 (I6/v6.33 lib 6/12N) SD

Main Hall
On a chair is an armored woman with flowing purple hair.

>wait
Time passes.

>xyzzy
You chant the magic word, "Xyzzy!"

An imp appears holding a metal circle with a pair of dials in the center. It reads 6:19 pm with a sun behind the dials.

In a flash, the imp disappears.

>wait
Time passes.

>xyzzy
You chant the magic word, "Xyzzy!"

An imp appears holding a metal circle with a pair of dials in the center. It reads 6:20 pm with a sun behind the dials.

In a flash, the imp disappears.

* * *

>wait
Time passes.

The dragon attacks.

>xyzzy
You chant the magic word, "Xyzzy!"

An imp appears holding a metal circle with a pair of dials in the center. It reads 6:29 pm with a sun behind the dials.

In a flash, the imp disappears.

* * *

>wait
Time passes.

>n
You walk around the bar to get behind it.

Behind the Bar

>wait
Time passes.

* * *

Text Only Jam
TODO Headline by Joshua McLean
Release 3 / Serial number 191217 / Inform 7 build 6M62 (I6/v6.33 lib 6/12N) SD

Main Hall
On a chair is an armored woman with flowing purple hair.

>xyzzy;wait
I didn't understand that sentence.

>xyzzy, wait
You chant the magic word, "Xyzzy!"

An imp appears holding a metal circle with a pair of dials in the center. It reads 6:19 pm with a sun behind the dials.

In a flash, the imp disappears.

Time passes.

>wait, xyzzy
Time passes.

You chant the magic word, "Xyzzy!"

An imp appears holding a metal circle with a pair of dials in the center. It reads 6:24 pm with a sun behind the dials.

In a flash, the imp disappears.

The dragon attacks.

>wait
Time passes.

* * *

Text Only Jam
TODO Headline by Joshua McLean
Release 3 / Serial number 191217 / Inform 7 build 6M62 (I6/v6.33 lib 6/12N) SD

Main Hall
On a chair is an armored woman with flowing purple hair.

>w
Cloakroom

>s
(first opening the entry door)
You'd best not.

>open door
You'd best not.

>n
You can't go that way.

>e
Main Hall
On a chair is an armored woman with flowing purple hair.

>n
You walk around the bar to get behind it.

Behind the Bar

>n
Kitchen

* * *

Text Only Jam
TODO Headline by Joshua McLean
Release 3 / Serial number 191217 / Inform 7 build 6M62 (I6/v6.33 lib 6/12N) SD

Main Hall
On a chair is an armored woman with flowing purple hair.

>n
You walk around the bar to get behind it.

Behind the Bar

>n
(first opening the kitchen door)
You step through into the kitchen and close the door behind yourself.

>actions
Actions listing on.

>s
[going south]
(first opening the kitchen door)
[(1) opening the kitchen door - silently]
[(1) opening the kitchen door - silently - succeeded]

Behind the Bar
[going south - succeeded]

>n
[going north]
[(1) closing the kitchen door]
You close the kitchen door.
[(1) closing the kitchen door - succeeded]

[going north - succeeded]

* * *

>n
(first opening the kitchen door)
You step through into the kitchen and close the door behind yourself.

>l
Kitchen

>x door
A wooden door is set in the southern wall .

>open door
You open the kitchen door.

>s
Behind the Bar