Hogtooth Tavern
An unfinished proof of concept for 8 Bits to Infinity Text Only Jam by Joshua McLean
Release 0 / Serial number 191220 / Inform 7 build 6M62 (I6/v6.33 lib 6/12N) SD

Main Hall (on your chair)
This hall lit dimly by rows after row of candles along the walls features a large benched table to the south and several round tables with chairs in the center. Along the north wall runs a bar, and a passage west leads to the cloakroom and the tavern's exit.

A stout, round man with curly black hair peeking over the top of his doublet wipes down the bar with a rag.

A man with shoulder-cropped blond hair strums on a lute and sings a wordless tune, filling the empty tavern air above the many conversations with beautiful music.

You can also see Saffi's chair (on which is Saffi) here.

>wait
Time passes.

* * *

>stand
You get off your chair.

Main Hall
This hall lit dimly by rows after row of candles along the walls features a large benched table to the south and several round tables with chairs in the center. Along the north wall runs a bar, and a passage west leads to the cloakroom and the tavern's exit.

A stout, round man with curly black hair peeking over the top of his doublet wipes down the bar with a rag.

A man with shoulder-cropped blond hair strums on a lute and sings a wordless tune, filling the empty tavern air above the many conversations with beautiful music.

You can also see Saffi's chair (on which is Saffi) and your chair here.

>ask keeper about mug
The barkeep looks at you expectantly.

The barkeep pulls a mug of ale and pounds it on the counter. "Two copper," he says.

>buy ale
(Beverage)
Try asking about Beverage instead.

>pay for ale
(Beverage)
You don't need to pay for Beverage.

>i
You are carrying:
  the coin purse

>get mug
(Beverage)
Taken.

>drink mug
(Beverage)
You can't drink that.

* * *

>ask keeper about beer
The barkeep looks at you expectantly.

There is no reply.

>ask keeper about mug
There is no reply.

* * *

>i
You are carrying:
  the coin purse
  a mug

>x mug
You see nothing special about the mug.

Inside the mug is ale.

>x purse
A small purse with 10 coins.

>look in mug
You find nothing of interest.

>drink mug
You drink ale from the mug. Tasty!

>drink mug
The mug is empty. Nothing to drink in there.

>drink mug
The mug is empty. Nothing to drink in there.

* * *

>x mug
A metal flask with a handle for knocking it back. You prefer to savor the ale, though.

Inside the mug is ale.

>drink mug
You drink ale from the mug. Tasty!

>stand
You get off your chair.

Main Hall
This hall lit dimly by rows after row of candles along the walls features a large benched table to the south and several round tables with chairs in the center. Along the north wall runs a bar, and a passage west leads to the cloakroom and the tavern's exit.

A stout, round man with curly black hair peeking over the top of his doublet wipes down the bar with a rag.

A man with shoulder-cropped blond hair strums on a lute and sings a wordless tune, filling the empty tavern air above the many conversations with beautiful music.

You can also see Saffi's chair (on which is Saffi) and your chair here.

>stand
There's nothing to stand on.

>ask barkeep about mug
The barkeep looks at you expectantly.

He grabs the mug out of your hand, fills it up, and slides it along the bar. "Two copper."

>l
Main Hall
This hall lit dimly by rows after row of candles along the walls features a large benched table to the south and several round tables with chairs in the center. Along the north wall runs a bar, and a passage west leads to the cloakroom and the tavern's exit.

On the bar is a mug.

A stout, round man with curly black hair peeking over the top of his doublet waits for you to pay for your ale.

A man with shoulder-cropped blond hair strums on a lute and sings a wordless tune, filling the empty tavern air above the many conversations with beautiful music.

You can also see Saffi's chair (on which is Saffi) and your chair here.

>w
"Ey!" the barkeep shouts after you. "Don't think ye'll be leavin this unpaid."

Cloakroom
A room for hanging coats. The main hall of the tavern lies to the east, while a door south exits to the streets.

>e
Main Hall
This hall lit dimly by rows after row of candles along the walls features a large benched table to the south and several round tables with chairs in the center. Along the north wall runs a bar, and a passage west leads to the cloakroom and the tavern's exit.

On the bar is a mug.

A stout, round man with curly black hair peeking over the top of his doublet waits for you to pay for your ale.

A man with shoulder-cropped blond hair strums on a lute and sings a wordless tune, filling the empty tavern air above the many conversations with beautiful music.

You can also see Saffi's chair (on which is Saffi) and your chair here.

>buy ale
Try asking about the mug instead.

* * *

>buy mug
You ought to get out of your chair first. He'll throw you out for shouting across the room.

>stand
You get off your chair.

Main Hall
This hall lit dimly by rows after row of candles along the walls features a large benched table to the south and several round tables with chairs in the center. Along the north wall runs a bar, and a passage west leads to the cloakroom and the tavern's exit.

A stout, round man with curly black hair peeking over the top of his doublet wipes down the bar with a rag.

A man with shoulder-cropped blond hair strums on a lute and sings a wordless tune, filling the empty tavern air above the many conversations with beautiful music.

You can also see Saffi's chair (on which is Saffi) and your chair here.

>buy mug
The barkeep looks at you expectantly.

"How about ye finish that one first, lad?" He points at the full mug in your hand.