Text Only Jam
TODO Headline by Joshua McLean
Release 3 / Serial number 191216 / Inform 7 build 6M62 (I6/v6.33 lib 6/12N) SD

Tunnel
You can see an armored woman with flowing purple hair, a short man with an enormous bow, and a tall woman in thin robes here.

>think about crap
It's pretty stinky.

* * *

>rules
Rules tracing now switched on. Type "rules off" to switch it off again, or "rules all" to include even rules which do not apply.

>rules all
[Rule "declare everything initially unmentioned rule" applies.]
Rules tracing now switched to "all". Type "rules off" to switch it off again.

>think about unicorns
[Rule "declare everything initially unmentioned rule" applies.]
[Rule "announce items from multiple object lists rule" applies.]
[Rule "set pronouns from items from multiple object lists rule" applies.]
[Rule "before stage rule" applies.]
[Rule "giving orders needs an interlocutor rule" does not apply (wrong action).]
[Rule "Before doing something to a secret door which is unrevealed" does not apply (wrong action).]
[Rule "Before doing something to a secret switch which is unrevealed" does not apply (wrong action).]
[Rule "can't converse with absent interlocutor rule" does not apply (wrong action).]
[Rule "greet a new interlocutor rule" does not apply (wrong action).]
[Rule "implicit-conversing needs current interlocutor rule" does not apply (wrong action).]
[Rule "Before doing something when a secret door is the second noun and the second noun is unrevealed" does not apply (wrong action).]
[Rule "Before doing something when a secret switch is the second noun and the second noun is unrevealed" does not apply (wrong action).]
[Rule "keychain-aware carrying requirements rule" applies.]
[Rule "instead stage rule" applies.]
[Rule "investigate player's awareness before action rule" applies.]
[Rule "player aware of his own actions rule" applies.]
[Rule "check stage rule" applies.]
[Rule "carry out stage rule" applies.]
[Rule "after stage rule" applies.]
[Rule "investigate player's awareness after action rule" applies.]
[Rule "report stage rule" applies.]
[Rule "last specific action-processing rule" applies.]
[Rule "A first turn sequence rule" applies.]
[Rule "every turn stage rule" applies.]
[Rule "Every turn" applies.]
[Rule "reset protocol rule" applies.]
[Rule "A last turn sequence rule" applies.]
[Rule "notify score changes rule" applies.]

* * *

Text Only Jam
TODO Headline by Joshua McLean
Release 3 / Serial number 191216 / Inform 7 build 6M62 (I6/v6.33 lib 6/12N) SD

Tunnel
You can see an armored woman with flowing purple hair, a short man with an enormous bow, and a tall woman in thin robes here.

>ponder
You stop and think for a moment, but nothing specific comes to mind. Maybe you need a HINT or to PONDER ABOUT something.

>ponder unicorns
I only understood you as far as wanting to ponder.

* * *

>ponder unicorns
You don't know anything about that.

* * *

Text Only Jam
TODO Headline by Joshua McLean
Release 3 / Serial number 191216 / Inform 7 build 6M62 (I6/v6.33 lib 6/12N) SD

Tunnel
You can see an armored woman with flowing purple hair, a short man with an enormous bow, and a tall woman in thin robes here.

>x me
As good-looking as ever.

>think about me
You're pretty cool.

* * *

Text Only Jam
TODO Headline by Joshua McLean
Release 3 / Serial number 191216 / Inform 7 build 6M62 (I6/v6.33 lib 6/12N) SD

Tunnel
You can see an armored woman with flowing purple hair, a short man with an enormous bow, and a tall woman in thin robes here.

>ponder saffi
You don't know anything about that.

* * *

Text Only Jam
TODO Headline by Joshua McLean
Release 3 / Serial number 191216 / Inform 7 build 6M62 (I6/v6.33 lib 6/12N) SD

Tunnel
You can see an armored woman with flowing purple hair, a short man with an enormous bow, and a tall woman in thin robes here.

>hello saffi
You say hello to Saffi.

>hello
You are already talking to Saffi.

>goodbye
You say goodbye to Saffi.

>hello
(addressing Saffi)
You say hello to Saffi.

>goodbye
You say goodbye to Saffi.

* * *

>hello
(addressing Saffi)
You say hello to Saffi.

>tunne
I didn't understand that sentence.

>ask about tunnel
There is no reply.

>ask saffi about tunnel
There is no reply.

>ask me about me
Talking to yourself is likely to prove unrewarding.

* * *

Text Only Jam
TODO Headline by Joshua McLean
Release 3 / Serial number 191216 / Inform 7 build 6M62 (I6/v6.33 lib 6/12N) SD

Tunnel
You can see an armored woman with flowing purple hair, a short man with an enormous bow, and a tall woman in thin robes here.

>ask saffi about tunnel
"Hey," she says.There is no reply.

* * *

Text Only Jam
TODO Headline by Joshua McLean
Release 3 / Serial number 191216 / Inform 7 build 6M62 (I6/v6.33 lib 6/12N) SD

Tunnel
You can see an armored woman with flowing purple hair, a short man with an enormous bow, and a tall woman in thin robes here.

>ask saffi about me
"Hey," she says. "You're okay. That's good."

>ask about tunnel
There is no reply.

>bye
Saffi waves.

* * *

>ask saffi about me
"Hey," she says. "You're okay. That's good."

>ask saffi about me
"You're okay. That's good."

>ask saffi about me
"You're okay. That's good."

* * *

Text Only Jam
TODO Headline by Joshua McLean
Release 3 / Serial number 191216 / Inform 7 build 6M62 (I6/v6.33 lib 6/12N) SD

Tunnel
You can see an armored woman with flowing purple hair, a short man with an enormous bow, and a tall woman in thin robes here.

>ask woman about herself
You can't see any such thing.

>ask woman
You can't see any such thing.

>hello woman
You can't see any such thing.

>l
Tunnel
Saffi is here.

You can also see Rale and Tira here.

>ask saffi about herself
"Hey," she says. "Oh, I'm Saffi. That's all I remember. And something about... a dragon?"

* * *

Text Only Jam
TODO Headline by Joshua McLean
Release 3 / Serial number 191216 / Inform 7 build 6M62 (I6/v6.33 lib 6/12N) SD

Tunnel
You can see an armored woman with flowing purple hair, a short man with an enormous bow, and a tall woman in thin robes here.

>rules all
Rules tracing now switched to "all". Type "rules off" to switch it off again.

>x woman
You can't see any such thing.

* * *

Text Only Jam
TODO Headline by Joshua McLean
Release 3 / Serial number 191216 / Inform 7 build 6M62 (I6/v6.33 lib 6/12N) SD

Tunnel
You can see an armored woman with flowing purple hair, a short man with an enormous bow, and a tall woman in thin robes here.

>talk to woman
You can't see any such thing.

* * *

Text Only Jam
TODO Headline by Joshua McLean
Release 3 / Serial number 191216 / Inform 7 build 6M62 (I6/v6.33 lib 6/12N) SD

Tunnel
You can see an armored woman with flowing purple hair, a short man with an enormous bow, and a tall woman in thin robes here.

>x woman
Who do you mean, an armored woman with flowing purple hair or a tall woman in thin robes?

>armored
You see nothing special about an armored woman with flowing purple hair.

>ask woman about hersef
Who do you mean, an armored woman with flowing purple hair or a tall woman in thin robes?

>ask woman about herself
Who do you mean, an armored woman with flowing purple hair or a tall woman in thin robes?

>armored
"Hey," she says. "Oh, I'm Saffi. That's all I remember. And something about... a dragon?"

>l
Tunnel
You can see Saffi, a short man with an enormous bow, and a tall woman in thin robes here.

>think about saffi
No specific memories come to mind.

* * *

Text Only Jam
TODO Headline by Joshua McLean
Release 3 / Serial number 191216 / Inform 7 build 6M62 (I6/v6.33 lib 6/12N) SD

Tunnel
You can see an armored woman with flowing purple hair, a short man with an enormous bow, and a tall woman in thin robes here.

>ask Saffi about Rale
"Hey," she says. "He rubs me the wrong way. Not sure why."

>ask saffi about herself
"Oh, I'm Saffi. That's all I remember. And something about... a dragon?"

>think about saffi
An armored woman with flowing, purple hair.

* * *

Text Only Jam
TODO Headline by Joshua McLean
Release 3 / Serial number 191216 / Inform 7 build 6M62 (I6/v6.33 lib 6/12N) SD

Tunnel
You can see an armored woman with flowing purple hair, a short man with an enormous bow, and a tall woman in thin robes here.

>think about saffi
No specific memories come to mind.

>ask saffi about rale
"Hey," she says. "He rubs me the wrong way. Not sure why."

>ask about herself
"Oh, I'm Saffi. That's all I remember. And something about... a dragon?"

>ponder saffi
She doesn't like Rale. An armored woman with flowing, purple hair.

* * *

Text Only Jam
TODO Headline by Joshua McLean
Release 3 / Serial number 191216 / Inform 7 build 6M62 (I6/v6.33 lib 6/12N) SD

Tunnel
You can see an armored woman with flowing purple hair, a short man with an enormous bow, and a tall woman in thin robes here.

>help
> Introduction to Text Only Jam
   Instructions for Play
   Additional commands
   Contact the author
   Additional credits

>[enter]
Originally developed for the 8 Bits to Infinity Text Only Jam from December 13-20, 2019, Bardolf's Curse is a location-based, puzzle-focused piece of interactive fiction--or, as the author prefers, a text adventure.

Please press SPACE to continue.

> Introduction to Text Only Jam
   Instructions for Play
   Additional commands
   Contact the author
   Additional credits

 > Introduction to Text Only Jam
   Instructions for Play
   Additional commands
   Contact the author
   Additional credits

>[down]
Introduction to Text Only Jam
 > Instructions for Play
   Additional commands
   Contact the author
   Additional credits

   Introduction to Text Only Jam
 > Instructions for Play
   Additional commands
   Contact the author
   Additional credits

>[enter]
> About Interactive Fiction
   What to do with >
   Getting Started
   Rooms and Travel
   Objects
   Controlling the Game
   How the World is Assembled
   If You Get Stuck

>[down]
About Interactive Fiction
 > What to do with >
   Getting Started
   Rooms and Travel
   Objects
   Controlling the Game
   How the World is Assembled
   If You Get Stuck

   About Interactive Fiction
 > What to do with >
   Getting Started
   Rooms and Travel
   Objects
   Controlling the Game
   How the World is Assembled
   If You Get Stuck

>[down]
About Interactive Fiction
   What to do with >
 > Getting Started
   Rooms and Travel
   Objects
   Controlling the Game
   How the World is Assembled
   If You Get Stuck

   About Interactive Fiction
   What to do with >
 > Getting Started
   Rooms and Travel
   Objects
   Controlling the Game
   How the World is Assembled
   If You Get Stuck

>[down]
About Interactive Fiction
   What to do with >
   Getting Started
 > Rooms and Travel
   Objects
   Controlling the Game
   How the World is Assembled
   If You Get Stuck

   About Interactive Fiction
   What to do with >
   Getting Started
 > Rooms and Travel
   Objects
   Controlling the Game
   How the World is Assembled
   If You Get Stuck

>[down]
About Interactive Fiction
   What to do with >
   Getting Started
   Rooms and Travel
 > Objects
   Controlling the Game
   How the World is Assembled
   If You Get Stuck

   About Interactive Fiction
   What to do with >
   Getting Started
   Rooms and Travel
 > Objects
   Controlling the Game
   How the World is Assembled
   If You Get Stuck

>[down]
About Interactive Fiction
   What to do with >
   Getting Started
   Rooms and Travel
   Objects
 > Controlling the Game
   How the World is Assembled
   If You Get Stuck

   About Interactive Fiction
   What to do with >
   Getting Started
   Rooms and Travel
   Objects
 > Controlling the Game
   How the World is Assembled
   If You Get Stuck

>[down]
About Interactive Fiction
   What to do with >
   Getting Started
   Rooms and Travel
   Objects
   Controlling the Game
 > How the World is Assembled
   If You Get Stuck

   About Interactive Fiction
   What to do with >
   Getting Started
   Rooms and Travel
   Objects
   Controlling the Game
 > How the World is Assembled
   If You Get Stuck

>[down]
About Interactive Fiction
   What to do with >
   Getting Started
   Rooms and Travel
   Objects
   Controlling the Game
   How the World is Assembled
 > If You Get Stuck

   About Interactive Fiction
   What to do with >
   Getting Started
   Rooms and Travel
   Objects
   Controlling the Game
   How the World is Assembled
 > If You Get Stuck

>[enter]
> Explore
   Read carefully
   Be creative
   Cooperate

>[down]
Explore
 > Read carefully
   Be creative
   Cooperate

   Explore
 > Read carefully
   Be creative
   Cooperate

>[down]
Explore
   Read carefully
 > Be creative
   Cooperate

   Explore
   Read carefully
 > Be creative
   Cooperate

>[down]
Explore
   Read carefully
   Be creative
 > Cooperate

   Explore
   Read carefully
   Be creative
 > Cooperate

>[enter]
Play with someone else. Two heads are often better than one. If that doesn't work, try emailing the author or (better yet) posting a request for hints on the newsgroup rec.games.int-fiction.  For best results, put the name of the game you want help with in the subject line; then leave a page or so of blank spoiler space (so that no one will read about where you got to in the game unless they've already played it), and describe your problem as clearly as possible.  Someone will probably be able to tell you how to get around it.

Please press SPACE to continue.

Explore
   Read carefully
   Be creative
 > Cooperate

   Explore
   Read carefully
   Be creative
 > Cooperate

>[esc]
About Interactive Fiction
   What to do with >
   Getting Started
   Rooms and Travel
   Objects
   Controlling the Game
   How the World is Assembled
 > If You Get Stuck

>[esc]
Introduction to Text Only Jam
 > Instructions for Play
   Additional commands
   Contact the author
   Additional credits

>[down]
Introduction to Text Only Jam
   Instructions for Play
 > Additional commands
   Contact the author
   Additional credits

   Introduction to Text Only Jam
   Instructions for Play
 > Additional commands
   Contact the author
   Additional credits

>[enter]
Conversation and remembrance are two key parts of this adventure.

You can TALK TO (person) to initiate conversation, then ASK ABOUT (something). A shortcut is to ASK (person) ABOUT (something) which will initiate conversation {i}and{/i} ask about the topic.

You can also TELL (something) or shorthand TELL (person) ABOUT (something) to inform other characters about people, places, or things.

Stuck? Try a plain THINK or PONDER for a general review what you've learned so far. Also, HINT will give you a menu of hints.

UNDO is enabled in this game because I'm a nice person. But be careful about overusing it. That's a good way to break the game. :(

If you have parchment and a pen, you can WRITE (message) ON PARCHMENT. Whenever you write a message, it overwrites the previous message. You can READ PARCHMENT to see the text and ERASE PARCHMENT to clear all text in it. If you're worried about overwriting the information in the notebook, use PROTECT PARCHMENT and the game will stop you from changing the text. Use UNPROTECT PARCHMENT if you want to edit it again.

You can EMPTY a container which drops everything in it onto the floor--including things you can't normally remove like liquids.

Check your SCORE to see how many points you've found. Some of these are secrets!

Please press SPACE to continue.

Introduction to Text Only Jam
   Instructions for Play
 > Additional commands
   Contact the author
   Additional credits

   Introduction to Text Only Jam
   Instructions for Play
 > Additional commands
   Contact the author
   Additional credits

>[down]
Introduction to Text Only Jam
   Instructions for Play
   Additional commands
 > Contact the author
   Additional credits

   Introduction to Text Only Jam
   Instructions for Play
   Additional commands
 > Contact the author
   Additional credits

>[enter]
If you find any bugs, typos, weird responess, or simply want to comment on the game, please contact me. Please include a transcript with your email if you have one. I appreciate your help!

E-mail:  joshua.mclean@8bitstoinfinity.com Twitter: @MrJoshuaMcLean Website: https://joshua-mclean.itch.io/

Please press SPACE to continue.

Introduction to Text Only Jam
   Instructions for Play
   Additional commands
 > Contact the author
   Additional credits

   Introduction to Text Only Jam
   Instructions for Play
   Additional commands
 > Contact the author
   Additional credits

>[down]
Introduction to Text Only Jam
   Instructions for Play
   Additional commands
   Contact the author
 > Additional credits

   Introduction to Text Only Jam
   Instructions for Play
   Additional commands
   Contact the author
 > Additional credits

>[enter]
TO DO additional credits

Please press SPACE to continue.

Introduction to Text Only Jam
   Instructions for Play
   Additional commands
   Contact the author
 > Additional credits

   Introduction to Text Only Jam
   Instructions for Play
   Additional commands
   Contact the author
 > Additional credits

>[esc]
Tunnel
You can see an armored woman with flowing purple hair, a short man with an enormous bow, and a tall woman in thin robes here.